bo,bx,bx,bx,bx,bx,bx,bx,bx,bo
bo,ox,xx,xx,xx,xx,xx,xx,ox,bx
bx,ox,ox,xx,xx,xx,xx,ox,xx,bx
bx,xx,ox,ox,xx,xx,ox,xx,xx,bx
2x,xx,xx,ox,ox,ox,xx,xx,xx,1x
2x,xx,xx,xx,ox,ox,ox,xx,xx,1x
bx,xx,xx,ox,xx,xx,ox,ox,xx,bx
bx,xx,ox,xx,xx,xx,xx,ox,ox,bx
bx,ox,xx,xx,xx,xx,xx,xx,ox,bo
bo,bx,bx,bx,qx,qx,bx,bx,bx,bo
