o,b,b,x,x,x,x,x,x,x
w,w,w,w,w,w,w,w,x,x
P,R,P,x,x,x,x,x,x,x
P,P,P,x,x,x,x,x,x,x
x,x,x,x,x,x,x,x,x,x
p,p,p,p,p,x,x,x,x,x
p,p,p,p,p,x,x,x,x,x
p,p,p,p,p,x,x,x,x,x
p,p,p,p,p,x,x,x,x,x
p,p,p,p,p,x,x,x,x,o
