xx,xx,xx,xx,xx,xx,xx,xx,xx,ox
xx,xx,xx,px,xx,xx,xx,xx,xx,ox
xx,xx,1x,1x,xx,xx,xx,xx,xx,xx
xx,rx,xx,1x,xx,xx,xx,xx,xx,xx
xx,xx,1x,1x,xx,xx,xx,xx,xx,xx
xx,xx,xx,1x,xx,xx,xx,xx,xx,xx
xx,xx,xx,1x,xx,xx,xx,xx,xx,xx
xx,xx,xx,1x,xx,xx,xx,xx,xx,xx
xx,xx,xx,xx,xx,xx,xx,xx,xx,xx
xx,xx,xx,xx,xx,xx,xx,xx,xx,xx
