wx,wx,wx,wx,wx,wx,wx,wx,wx,wx
wx,wx,wx,wx,wx,wx,wx,wx,wx,wx
wx,wx,ox,xx,xx,xx,xx,ox,wx,wx
wx,wx,xx,Pp,xx,wx,wx,xx,wx,wx
wx,wx,xx,xx,bx,bx,wx,xx,wx,wx
wx,wx,xx,wx,bx,bx,xx,xx,wx,wx
wx,wx,xx,wx,wx,xx,Qx,xx,wx,wx
wx,wx,ox,xx,xx,xx,xx,ox,wx,wx
wx,wx,wx,wx,wx,wx,wx,wx,wx,wx
wx,wx,wx,wx,wx,wx,wx,wx,wx,wx
