bx,bx,bx,bx,bx,bx,bx,bx,bx,bx
bx,qx,xx,xx,xx,xx,xx,xx,ox,bx
bx,xx,xx,xx,xx,xx,xx,xx,ox,bx
bx,xx,xx,ox,ox,ox,ox,xx,xx,bx
bx,xx,ox,xx,xx,ox,xx,xx,xx,bx
bx,xx,ox,ox,xx,xx,xx,xx,xx,bx
bx,xx,xx,xx,xx,xx,xx,xx,xx,bx
bx,xx,xx,ox,ox,xx,xx,xx,xx,bx
bx,xx,xx,xx,ox,xx,xx,xx,xx,bx
bx,bx,bx,bx,bx,bx,bx,bx,bx,bx
