xx,xx,xx,xx,xx,xx,xx,xx,xx,xx
wx,Px,wx,Qx,wx,Px,wx,Qx,wx,xx
wx,xx,wx,xx,wx,xx,wx,xx,wx,xx
wx,xx,wx,xx,wx,xx,wx,xx,wx,xx
wx,ox,wx,bx,wx,ox,wx,bx,wx,xx
wx,bx,wx,ox,wx,bx,wx,ox,wx,xx
wx,xx,wx,xx,wx,xx,wx,xx,wx,xx
wx,xx,wx,xx,wx,xx,wx,xx,wx,xx
wx,Qx,wx,Px,wx,Qx,wx,Px,wx,xx
px,xx,xx,xx,xx,xx,xx,xx,xx,xx
