wx,wx,wx,wx,wx,wx,wx,wx,wx,wx
wx,wx,wx,wx,wx,wx,wx,wx,wx,wx
wx,wx,wx,wx,wx,wx,wx,wx,wx,wx
wx,wx,wx,wx,xx,xx,xx,xx,wx,wx
wx,wx,wx,wx,bx,bx,bx,xx,wx,wx
wx,wx,wx,ox,ox,wx,xx,xx,wx,wx
wx,xx,bx,ox,ox,px,xx,wx,wx,wx
wx,xx,xx,xx,xx,xx,xx,wx,wx,wx
wx,wx,wx,wx,wx,wx,wx,wx,wx,wx
wx,wx,wx,wx,wx,wx,wx,wx,wx,wx
