x,1,1,1,1,1,2,2,2,o
x,x,x,x,x,1,2,x,x,x
x,x,x,x,x,1,2,x,x,x
x,x,x,x,x,1,2,w,x,s
x,x,x,x,x,x,w,w,p,p
x,x,x,x,x,4,3,w,x,r
x,x,x,x,x,4,3,x,x,x
x,x,x,x,x,4,3,x,x,x
x,x,x,x,x,4,3,x,x,x
x,x,4,4,4,4,3,3,3,o
