b,b,b,b,b,b,b,b,b,b
b,@,x,x,x,x,x,x,o,b
b,x,x,x,x,x,x,x,o,b
b,x,x,o,o,o,o,x,x,b
b,x,o,x,x,o,x,x,x,b
b,x,o,o,x,x,x,x,x,b
b,x,x,x,x,x,x,x,x,b
b,x,x,o,o,x,x,x,x,b
b,x,x,x,o,x,x,x,x,b
b,b,b,b,b,b,b,b,b,b
