w,w,w,w,w,w,w,w,w,w
w,w,w,w,w,w,w,w,w,w
w,w,x,x,@,x,x,w,w,w
w,w,x,b,b,b,x,w,x,w
w,w,w,o,o,o,w,w,x,w
w,w,w,o,o,o,w,w,x,w
w,w,x,b,b,b,x,w,x,w
w,w,x,x,p,x,x,w,x,w
w,w,w,w,w,w,w,w,w,w
w,w,w,w,w,w,w,w,w,w
