xx,wx,1x,xx,xx,xx,ox,ox,ox,po
wx,wx,1x,xx,xx,xx,ox,xx,xx,ox
1x,1x,1x,xx,xx,xx,ox,xx,xx,ox
xx,xx,xx,wx,wx,xx,ox,ox,ox,ox
xx,xx,xx,wx,bx,xx,xx,xx,xx,xx
xx,xx,xx,xx,xx,bx,wx,xx,xx,xx
xx,xx,xx,xx,xx,wx,wx,xx,xx,xx
xx,xx,xx,xx,xx,xx,xx,2x,2x,2x
xx,xx,xx,xx,xx,xx,xx,2x,wx,wx
qx,xx,xx,xx,xx,xx,xx,2x,wx,xx
