x,x,x,x,x,x,x,x,x,x
1,1,x,x,x,w,x,w,x,x
x,x,x,w,x,w,x,w,x,x
b,w,x,w,o,w,x,w,x,q
b,w,x,w,o,w,x,w,o,o
b,w,x,w,o,w,x,w,o,b
b,w,x,w,o,w,x,w,o,o
x,x,x,w,x,w,x,w,x,r
2,2,x,x,x,w,x,w,x,x
x,x,x,x,x,x,x,x,x,x
