Qx,Px,Qx,Px,Qx,Px,Qx,Px,Qx,Px
Pb,Qx,Px,Qx,Px,Qx,Px,Qx,Px,Qx
Qb,Px,Qx,Px,Qx,Px,Qx,Px,Qx,Px
Px,Qx,Px,Qx,Px,Qx,Px,Qx,Px,Qx
Qx,Px,Q1,Px,Qx,Px,Qx,Px,Qx,Px
Px,Qx,P1,Qx,Px,Qx,Px,Qx,Px,Qx
Qx,Px,Q1,Px,Qx,Px,Qx,ox,ox,Px
Px,Qx,Px,Qx,Px,Qx,Px,Qx,ox,Qx
Qx,Px,Qx,Px,Qx,Px,Qx,ox,ox,Px
Pp,Qx,Px,Qx,Px,Qx,Px,Qx,Px,Qx
