xx,xx,xx,xx,xx,xx,xx,xx,xx,xx
qx,1x,1x,!x,!x,!x,xx,0x,xx,0x
xx,1x,1x,xx,xx,0x,0x,0x,0x,0x
xx,1x,1x,@x,xx,0x,0x,0x,9x,0x
xx,1x,1x,@x,xx,bx,px,9x,9x,0x
2x,1x,1x,@x,xx,6x,7x,9x,9x,0x
2x,3x,3x,xx,xx,6x,7x,8x,wx,ox
2x,4x,4x,xx,xx,6x,7x,8x,wx,bx
xx,4x,4x,5x,5x,5x,xx,xx,wx,bx
xx,4x,4x,xx,xx,xx,xx,xx,wx,ox
