x,p,x,w,b,w,x,x,x,x
x,x,x,w,o,w,x,x,w,x
x,x,x,w,q,w,w,x,w,x
x,x,x,x,x,w,w,x,w,x
w,w,w,x,x,w,w,x,w,o
b,x,w,x,x,x,x,x,x,x
o,x,x,x,x,b,w,w,w,w
o,x,x,x,w,w,x,x,x,x
w,w,r,s,w,w,x,x,x,x
x,x,b,x,w,w,x,x,x,x
