1x,1x,xx,xx,xx,xx,xx,xx,3x,3x
1x,1x,xx,xx,xx,ox,ox,xx,3x,3x
xx,xx,5x,5x,xx,ox,6o,6x,xx,xx
xx,xx,5x,5x,xx,ox,6o,6x,xx,xx
xx,ox,ox,ox,ox,ox,ox,xx,xx,xx
xx,ox,ox,ox,ox,qx,ox,ox,ox,ox
xx,xx,7x,7x,ox,ox,8o,8o,ox,ox
xx,xx,7x,7x,ox,ox,8x,8x,xx,xx
2x,2x,xx,xx,ox,ox,xx,xx,4x,4x
2x,2x,xx,xx,ox,ox,xx,xx,4x,4x
