wx,wx,wx,wx,wx,wx,wx,wx,wx,wx
wx,wx,wx,wx,wx,wx,wx,wx,wx,wx
wx,wx,wx,wx,ox,ox,wx,wx,wx,wx
wx,wx,wx,wx,xx,xx,wx,wx,wx,wx
wx,wx,wx,ox,xx,bx,ox,wx,wx,wx
wx,wx,wx,xx,bx,xx,xx,wx,wx,wx
wx,wx,xx,xx,wx,bx,bx,xx,wx,wx
wx,wx,px,xx,xx,xx,xx,xx,wx,wx
wx,wx,wx,wx,wx,wx,wx,wx,wx,wx
wx,wx,wx,wx,wx,wx,wx,wx,wx,wx
