xx,xx,xx,xx,wx,wx,xx,xx,xx,px
bx,xx,xx,xx,wx,wx,xx,xx,xx,ox
xx,bx,xx,xx,wx,wx,xx,xx,ox,xx
xx,xx,bx,xx,wx,wx,xx,ox,xx,xx
xx,xx,xx,bx,wx,wx,ox,xx,xx,xx
xx,xx,xx,ox,wx,wx,bx,xx,xx,xx
xx,xx,ox,xx,wx,wx,xx,bx,xx,xx
xx,ox,xx,xx,wx,wx,xx,xx,bx,xx
ox,xx,xx,xx,wx,wx,xx,xx,xx,bx
qx,xx,xx,xx,wx,wx,xx,xx,xx,xx
