1x,1x,xx,xx,xx,xx,ox,ox,wx,px
1x,1x,xx,xx,xx,xx,ox,ox,wx,xx
wx,wx,xx,xx,xx,xx,wx,xx,xx,xx
ox,ox,xx,xx,xx,xx,xx,xx,xx,xx
ox,ox,xx,xx,xx,wx,wx,xx,xx,xx
xx,xx,xx,xx,xx,xx,xx,xx,xx,xx
xx,xx,xx,xx,xx,wx,xx,wx,xx,xx
xx,xx,xx,wx,xx,xx,xx,xx,xx,xx
xx,xx,xx,wx,xx,xx,xx,xx,xx,xx
xx,xx,rx,wx,xx,xx,bx,bx,bx,bx
