xx,xx,xx,xx,xx,xx,xx,xx,xx,xx
1x,1x,xx,xx,xx,wx,xx,wx,xx,xx
xx,xx,xx,wx,xx,wx,xx,wx,xx,xx
bx,wx,xx,wx,ox,wx,xx,wx,xx,qx
bx,wx,xx,wx,ox,wx,xx,wx,ox,ox
bx,wx,xx,wx,ox,wx,xx,wx,ox,bx
bx,wx,xx,wx,ox,wx,xx,wx,ox,ox
xx,xx,xx,wx,xx,wx,xx,wx,xx,rx
2x,2x,xx,xx,xx,wx,xx,wx,xx,xx
xx,xx,xx,xx,xx,xx,xx,xx,xx,xx
