xx,xx,xx,xx,xx,xx,xx,xx,xx,xx
xx,bx,xx,xx,xx,xx,xx,xx,xx,xx
xx,xx,xx,xx,xx,xx,xx,xx,xx,xx
xx,xx,xx,xx,xx,xx,xx,xx,xx,xx
xx,xx,xx,xx,px,xx,xx,xx,xx,xx
xx,xx,xx,xx,xx,xx,xx,xx,xx,xx
xx,xx,xx,xx,xx,xx,xx,xx,xx,xx
xx,xx,xx,xx,xx,xx,xx,ox,xx,xx
xx,xx,xx,xx,xx,xx,xx,xx,xx,xx
xx,xx,xx,xx,xx,xx,xx,xx,xx,xx
