8x,8x,9x,xx,xx,xx,xx,xx,xx,qx
6x,9x,9x,xx,xx,xx,xx,xx,Px,xx
6x,9x,bx,xx,xx,xx,xx,xx,xx,xx
6x,4x,4x,xx,xx,xx,xx,xx,xx,xx
1x,3x,4x,xx,xx,xx,xx,xx,xx,xx
1x,3x,4x,xx,xx,xx,xx,xx,xx,xx
2x,3x,5x,xx,xx,xx,xx,xx,xx,xx
2o,2o,5o,ox,ox,ox,ox,ox,ox,ox
7o,bo,5o,ox,ox,ox,ox,ox,ox,ox
7o,7o,7o,ox,ox,ox,ox,ox,ox,ox
