xx,xx,xx,xx,xx,xx,xx,xx,xx,xx
xx,xx,xx,xx,xx,xx,xx,xx,xx,xx
xx,xx,xx,xx,xx,xx,xx,xx,xx,xx
bx,bx,bx,xx,qx,xx,xx,bx,bx,bx
wx,wx,wx,wx,Rx,wx,wx,wx,wx,wx
xx,xx,xx,xx,px,xx,xx,xx,xx,xx
xx,xx,xx,wx,wx,wx,xx,xx,xx,xx
xx,xx,xx,xx,xx,xx,xx,xx,xx,xx
xx,xx,xx,xx,xx,xx,xx,xx,xx,xx
xx,ox,ox,ox,xx,xx,ox,ox,ox,xx
