wx,wx,wx,wx,wx,wx,wx,wx,wx,wx
Qx,xx,xx,xx,xx,xx,xx,xx,xx,xx
wx,wx,wx,wx,wx,wx,wx,wx,xx,xx
xx,xx,xx,xx,xx,xx,xx,xx,xx,xx
xx,bx,xx,xx,xx,xx,xx,xx,xx,xx
wx,wx,wx,xx,xx,xx,xx,xx,wx,xx
Qx,xx,wx,xx,bx,xx,xx,xx,wx,xx
Qx,xx,wx,xx,ox,xx,xx,wx,wx,xx
Qx,xx,wx,xx,ox,xx,xx,wx,wx,ox
wx,px,bx,bx,wx,xx,xx,wx,wx,po
