wx,wx,xx,xx,xx,xx,xx,xx,xx,wx
wx,wx,2x,2x,2x,3o,3o,3o,ox,xx
xx,2x,ox,xx,2x,3o,xx,xx,3o,xx
xx,2x,xx,qo,2x,3o,qx,xx,3o,xx
xx,2x,2x,2x,2o,3x,3o,3o,3o,xx
xx,1o,1o,1o,1x,bx,ox,ox,ox,xx
xx,1o,xx,qx,1o,ox,bx,xx,ox,xx
xx,1o,xx,xx,1o,ox,xx,bx,ox,xx
xx,ox,1o,1o,1o,ox,ox,ox,qx,xx
wx,xx,xx,xx,xx,xx,xx,xx,xx,wx
