wx,wx,wx,wx,wx,wx,wx,wx,wx,wx
wx,wx,wx,xx,xx,xx,wx,xx,xx,wx
wx,wx,wx,xx,wx,xx,xx,ox,xx,wx
wx,wx,xx,xx,wx,xx,ox,xx,xx,wx
wx,wx,xx,xx,xx,ox,wx,wx,xx,wx
wx,wx,wx,ox,ox,qx,ox,xx,xx,wx
wx,wx,xx,xx,xx,bx,bx,xx,xx,wx
wx,wx,wx,wx,wx,bx,bx,wx,wx,wx
wx,wx,wx,wx,wx,bx,bx,wx,wx,wx
wx,wx,wx,wx,wx,wx,wx,wx,wx,wx
