xx,xx,xx,xx,xx,xx,xx,xx,wx,ox
xx,xx,xx,xx,xx,xx,xx,xx,wx,xx
xx,wx,xx,bx,xx,xx,xx,xx,wx,xx
xx,wx,xx,xx,xx,xx,xx,xx,wx,xx
xx,wx,xx,xx,bx,xx,bx,xx,wx,xx
xx,wx,bx,xx,xx,xx,xx,xx,wx,xx
xx,wx,rx,xx,bx,xx,xx,xx,wx,xx
xx,wx,xx,xx,xx,xx,xx,bx,wx,xx
xx,wx,xx,xx,xx,xx,xx,xx,rx,xx
ox,wx,xx,xx,xx,xx,xx,xx,xx,xx
