wx,wx,wx,wx,wx,wx,wx,wx,wx,wx
wx,wx,wx,wx,wx,wx,wx,wx,wx,wx
wx,wx,ox,xx,xx,xx,xx,xx,wx,wx
wx,wx,xx,qo,xx,wx,wx,xx,wx,wx
wx,wx,xx,xx,bx,bP,wx,xx,wx,wx
wx,wx,xx,wx,bQ,bx,xx,xx,wx,wx
wx,wx,xx,wx,wx,xx,ox,xx,wx,wx
wx,wx,xx,xx,xx,xx,xx,ox,wx,wx
wx,wx,wx,wx,wx,wx,wx,wx,wx,wx
wx,wx,wx,wx,wx,wx,wx,wx,wx,wx
