o,o,x,x,o,o,x,x,x,x
o,o,x,x,o,o,x,x,x,x
x,x,1,1,1,1,1,1,x,x
x,x,1,P,x,x,Q,1,x,x
o,o,1,x,h,h,x,1,x,x
o,o,1,x,h,h,x,1,x,x
x,x,1,p,x,x,R,1,x,x
x,x,1,1,1,1,1,1,x,x
x,x,x,x,x,x,x,x,x,x
x,x,x,x,x,x,x,x,x,p
