o,o,x,x,o,o,x,x,x,x
o,o,x,x,o,o,x,x,x,x
x,x,1,1,1,1,1,1,x,x
x,x,1,q,x,x,r,1,x,x
o,o,1,x,h,h,x,1,x,x
o,o,1,x,h,h,x,1,x,x
x,x,1,p,x,x,s,1,x,x
x,x,1,1,1,1,1,1,x,x
x,x,x,x,x,x,x,x,x,x
x,x,x,x,x,x,x,x,x,p
