xx,xx,xx,xx,xx,ox,xx,xx,xx,xx
xx,xx,xx,xx,wx,xx,xx,xx,xx,xx
xx,1x,1x,1x,1x,xx,xx,xx,xx,xx
xx,1x,qx,xx,1x,xx,xx,xx,xx,xx
xx,1x,xx,xx,1x,xx,xx,xx,xx,xx
xx,xx,xx,qx,1x,xx,xx,xx,xx,xx
xx,xx,xx,xx,xx,xx,xx,xx,xx,xx
xx,xx,xx,xx,xx,xx,xx,wx,xx,ox
xx,xx,xx,xx,xx,xx,xx,2x,xx,2x
ox,xx,xx,xx,xx,xx,xx,2x,2x,2x
