po,ox,ox,ox,ox,xx,xx,xx,xx,xx
ox,ox,3x,3x,xx,xx,xx,xx,wx,wx
ox,xx,3x,bx,2x,xx,xx,wx,wx,wx
ox,1x,1x,1x,2x,xx,wx,wx,wx,wx
ox,xx,xx,xx,2x,wx,wx,wx,wx,wx
xx,xx,xx,xx,wx,wx,wx,wx,wx,wx
xx,xx,xx,wx,wx,wx,wx,wx,wx,wx
xx,xx,wx,wx,wx,wx,wx,wx,wx,wx
xx,wx,wx,wx,wx,wx,wx,wx,wx,wx
wx,wx,wx,wx,wx,wx,wx,wx,wx,wx
