bx,xx,xx,bx,wx,bx,xx,wx,wx,wx
xx,xx,xx,xx,wx,xx,xx,Px,Qx,ox
xx,xx,xx,xx,wx,xx,xx,wx,wx,wx
xx,ox,xx,px,wx,xx,ox,xx,xx,2x
xx,ox,xx,1x,1x,1x,ox,xx,xx,2x
xx,ox,xx,rx,wx,xx,ox,xx,xx,2x
xx,ox,xx,xx,wx,xx,ox,xx,xx,2x
xx,xx,xx,xx,wx,xx,xx,wx,wx,wx
xx,xx,xx,xx,wx,xx,xx,Px,Qx,ox
bx,xx,xx,bx,wx,bx,xx,wx,wx,wx
