px,xx,xx,xx,xx,xx,xx,bx,bx,xx
xx,xx,xx,xx,xx,xx,xx,xx,xx,xx
xx,wx,wx,wx,wx,wx,xx,xx,xx,xx
xx,bx,xx,xx,ox,wx,Px,xx,xx,xx
xx,wx,wx,wx,wx,wx,xx,xx,xx,xx
xx,xx,xx,xx,xx,xx,xx,xx,xx,xx
xx,wx,wx,wx,wx,wx,xx,xx,xx,xx
xx,ox,xx,xx,bx,wx,Qx,xx,xx,xx
xx,wx,wx,wx,wx,wx,xx,xx,xx,xx
xx,xx,xx,xx,xx,xx,xx,ox,ox,xx
