po,xx,xx,xx,xx,xx,xx,xx,xx,ox
xx,xx,xx,xx,xx,xx,xx,xx,xx,xx
xx,xx,xx,xx,xx,xx,xx,xx,xx,xx
xx,xx,xx,Px,xx,wx,wx,xx,xx,xx
xx,xx,xx,xx,bx,bx,wx,xx,xx,xx
xx,xx,xx,wx,bx,bx,xx,xx,xx,xx
xx,xx,xx,wx,wx,xx,Qx,xx,xx,xx
xx,xx,xx,xx,xx,xx,xx,xx,xx,xx
xx,xx,xx,xx,xx,xx,xx,xx,xx,xx
ox,xx,xx,xx,xx,xx,xx,xx,xx,ox
