wx,wx,wx,wx,wx,wx,wx,wx,wx,wx
wx,wx,wx,wx,wx,wx,wx,wx,wx,wx
wx,wx,xx,xx,qx,xx,xx,wx,xx,wx
wx,wx,xx,bx,bx,bx,xx,wx,xx,wx
wx,wx,wx,ox,ox,ox,wx,wx,xx,wx
wx,wx,wx,ox,ox,ox,wx,wx,xx,wx
wx,wx,xx,bx,bx,bx,xx,wx,xx,wx
wx,wx,xx,xx,px,xx,xx,wx,xx,wx
wx,wx,wx,wx,wx,wx,wx,wx,wx,wx
wx,wx,wx,wx,wx,wx,wx,wx,wx,wx
