p,x,x,x,x,x,x,b,b,x
x,x,x,x,x,x,x,x,x,x
x,w,w,w,w,w,x,x,x,x
x,b,x,x,o,w,P,x,x,x
x,w,w,w,w,w,x,x,x,x
x,x,x,x,x,x,x,x,x,x
x,w,w,w,w,w,x,x,x,x
x,o,x,x,b,w,Q,x,x,x
x,w,w,w,w,w,x,x,x,x
x,x,x,x,x,x,x,o,o,x
