Rx,1x,1x,1x,1x,1x,1x,1x,1x,Rx
1x,wx,0x,xx,xx,3x,xx,xx,wx,1x
1x,0x,0x,0o,3x,3x,3o,xx,xx,1x
1x,xx,0o,ox,ox,3o,ox,ox,xx,1x
1x,xx,4x,ox,qx,2x,ox,xx,xx,1x
1x,4x,4x,4o,2x,2x,2o,xx,xx,1x
1x,xx,4o,ox,ox,2o,ox,ox,xx,1x
1x,xx,xx,ox,xx,xx,ox,qx,xx,1x
1x,wx,xx,xx,xx,xx,xx,xx,wx,1x
Rx,1x,1x,1x,1x,1x,1x,1x,1x,Rx
