@,x,w,w,w,w,w,w,x,p
x,x,w,w,w,w,w,w,x,x
x,b,x,x,x,w,w,w,x,x
x,w,x,x,q,r,b,x,x,x
x,w,x,w,w,w,b,w,x,x
x,x,b,w,o,o,x,w,w,w
w,x,w,w,o,o,x,w,w,w
w,b,w,w,o,o,x,w,w,w
w,b,x,x,x,x,x,w,w,w
w,w,w,w,x,x,x,w,w,w
