bx,wx,xx,xx,xx,xx,xx,wx,xx,Qx
xx,wx,xx,wx,wx,xx,xx,wx,xx,xx
xx,xx,xx,bx,xx,xx,xx,bx,xx,ox
xx,xx,xx,xx,2x,2x,2x,xx,xx,ox
xx,xx,wx,wx,wx,2x,wx,wx,3x,ox
xx,xx,wx,xx,xx,2x,3x,3x,3x,ox
xx,xx,wx,xx,wx,ox,4o,wx,3x,ox
1x,1x,1x,1x,wx,ox,4o,xx,xx,ox
px,xx,xx,xx,wx,wx,wx,wx,xx,xx
Px,bx,xx,xx,xx,xx,xx,xx,xx,bx
