e,x,x,b,b,x,x,x,x,o
x,o,x,b,b,x,x,x,o,x
x,x,x,w,w,w,w,x,x,x
b,b,w,w,w,w,w,w,x,x
b,b,w,w,w,w,w,w,x,x
x,x,w,w,w,w,w,w,x,x
x,x,w,w,w,w,w,w,x,x
x,x,x,w,w,w,w,P,x,x
x,o,x,x,x,x,x,x,o,x
o,x,x,x,x,x,x,x,x,o
