R,1,1,1,1,1,1,1,1,R
1,w,0,x,x,3,x,x,w,1
1,0,0,A,3,3,D,x,x,1
1,x,A,o,o,D,o,o,x,1
1,x,4,o,q,2,o,x,x,1
1,4,4,E,2,2,C,x,x,1
1,x,E,o,o,C,o,o,x,1
1,x,x,o,x,x,o,q,x,1
1,w,x,x,x,x,x,x,w,1
R,1,1,1,1,1,1,1,1,R
