px,xx,xx,wx,xx,wx,wx,wx,wx,xx
xx,xx,xx,wx,xx,wx,wx,wx,wx,xx
xx,bx,wx,wx,xx,wx,xx,xx,xx,xx
xx,xx,xx,xx,xx,wx,wx,xx,wx,xx
xx,bx,wx,wx,xx,wx,wx,xx,wx,xx
xx,xx,xx,wx,xx,wx,wx,xx,wx,xx
xx,xx,xx,wx,xx,wx,wx,xx,wx,xx
wx,wx,wx,wx,xx,wx,wx,xx,wx,ox
px,xx,xx,xx,xx,xx,xx,xx,wx,ox
wx,wx,wx,xx,xx,wx,wx,xx,xx,px
