xx,xx,xx,xx,1x,xx,xx,xx,bx,ox
xx,wx,wx,1x,1x,wx,xx,2x,wx,xx
xx,wx,wx,xx,1x,wx,2x,2x,wx,xx
xx,wx,wx,wx,1x,wx,wx,2x,wx,xx
xx,wx,wx,wx,1x,wx,wx,2x,wx,xx
xx,wx,wx,wx,1x,wx,wx,2x,wx,xx
xx,wx,wx,xx,1x,wx,wx,2x,wx,xx
xx,wx,wx,1x,1x,wx,xx,2x,wx,xx
xx,wx,wx,xx,1x,wx,2x,2x,wx,xx
px,xx,xx,xx,xx,xx,xx,2x,xx,xx
