wx,wx,xx,wx,wx,wx,xx,xx,xx,1x
wx,wx,ox,wx,wx,wx,xx,xx,xx,1x
wx,wx,ox,xx,xx,wx,xx,xx,xx,1x
xx,xx,ox,wx,xx,xx,xx,xx,xx,1x
xx,wx,ox,wx,wx,wx,wx,xx,wx,bx
xx,xx,xx,xx,xx,xx,xx,xx,xx,xx
xx,xx,xx,xx,xx,xx,xx,xx,xx,qx
xx,xx,xx,xx,xx,xx,xx,xx,xx,wx
xx,ox,xx,xx,xx,xx,xx,xx,xx,wx
wx,wx,wx,wx,wx,wx,xx,xx,wx,wx
