ox,ox,xx,xx,ox,ox,xx,xx,xx,xx
ox,ox,xx,xx,ox,ox,xx,xx,xx,xx
xx,xx,1x,1x,1x,1x,1x,1x,xx,xx
xx,xx,1x,Px,xx,xx,Qx,1x,xx,xx
ox,ox,1x,xx,bo,bo,xx,1x,xx,xx
ox,ox,1x,xx,bo,bo,xx,1x,xx,xx
xx,xx,1x,px,xx,xx,Rx,1x,xx,xx
xx,xx,1x,1x,1x,1x,1x,1x,xx,xx
xx,xx,xx,xx,xx,xx,xx,xx,xx,xx
xx,xx,xx,xx,xx,xx,xx,xx,xx,xx
