1,1,x,x,x,x,o,o,w,p
1,1,x,x,x,x,o,o,w,x
w,w,x,x,x,x,w,x,x,x
o,o,x,x,x,x,x,x,x,x
o,o,x,x,x,w,w,x,x,x
x,x,x,x,x,x,x,x,x,x
x,x,x,x,x,w,x,w,x,x
x,x,x,w,x,x,x,x,x,x
x,x,x,w,x,x,x,x,x,x
x,x,#,w,x,x,b,b,b,b
