xx,px,px,px,px,px,px,px,px,xx
px,px,1x,1x,px,px,px,px,px,px
px,px,1x,px,px,px,px,px,px,px
px,1x,1x,px,px,px,px,px,px,px
px,px,px,px,px,po,po,bx,px,px
px,px,px,px,px,po,px,px,px,px
px,px,px,bx,po,po,px,px,px,px
px,px,px,px,px,px,px,px,px,px
px,px,px,px,px,px,px,px,px,px
xx,px,px,px,px,px,px,px,px,xx
