x,x,x,x,x,x,x,x,x,x
w,P,w,Q,w,P,w,Q,w,x
w,x,w,x,w,x,w,x,w,x
w,x,w,x,w,x,w,x,w,x
w,o,w,b,w,b,w,o,w,x
w,b,w,o,w,o,w,b,w,x
w,x,w,x,w,x,w,x,w,x
w,x,w,x,w,x,w,x,w,x
w,Q,w,P,w,Q,w,P,w,x
p,x,x,x,x,x,x,x,x,x
