wx,wx,wx,wx,wx,wx,wx,wx,wx,wx
wx,wx,wx,wx,wx,wx,wx,wx,wx,wx
wx,wx,bx,xx,xx,xx,xx,wx,wx,wx
wx,wx,xx,bx,xx,wx,wx,xx,wx,wx
wx,wx,xx,xx,po,qo,wx,xx,wx,wx
wx,wx,xx,wx,qo,po,xx,xx,wx,wx
wx,wx,xx,wx,wx,xx,bx,xx,wx,wx
wx,wx,wx,xx,xx,xx,xx,bx,wx,wx
wx,wx,wx,wx,wx,wx,wx,wx,wx,wx
wx,wx,wx,wx,wx,wx,wx,wx,wx,wx
