x,x,x,x,x,x,x,x,x,x
q,1,1,%,%,%,x,0,x,0
x,1,1,x,x,0,0,0,0,0
x,1,1,^,x,0,0,0,9,0
x,1,1,^,x,b,p,9,9,0
2,1,1,^,x,6,7,9,9,0
2,3,3,x,x,6,7,8,w,o
2,4,4,x,x,6,7,8,w,b
x,4,4,5,5,5,x,x,w,b
x,4,4,x,x,x,x,x,w,o
