rx,xx,xx,xx,xx,xx,xx,xx,xx,xx
xx,xx,xx,xx,xx,xx,xx,1x,1x,1x
wx,wx,wx,wx,wx,wx,wx,wx,xx,1x
ox,bx,bx,xx,2x,xx,3x,xx,xx,1x
wx,wx,wx,xx,2x,xx,3x,1x,1x,1x
ox,ox,xx,xx,xx,xx,xx,xx,xx,xx
ox,ox,xx,xx,xx,xx,xx,xx,px,xx
wx,bx,wx,xx,wx,bx,wx,xx,xx,xx
wx,bx,wx,ox,wx,bx,wx,xx,xx,xx
wx,ox,wx,ox,wx,ox,wx,ox,xx,xx