ox,xx,xx,xx,wx,xx,bx,xx,wx,ox
wx,wx,xx,xx,wx,xx,xx,xx,wx,xx
xx,rx,xx,xx,xx,xx,xx,xx,xx,xx
xx,xx,xx,bx,xx,xx,xx,xx,xx,xx
xx,xx,xx,xx,xx,xx,xx,xx,wx,wx
wx,wx,xx,xx,bx,xx,xx,xx,rx,xx
xx,rx,xx,bx,xx,xx,bx,xx,xx,xx
xx,xx,xx,xx,xx,xx,xx,xx,xx,rx
xx,wx,xx,xx,xx,wx,bx,xx,wx,wx
ox,wx,xx,bx,xx,wx,xx,xx,xx,ox
