ox,bx,bx,xx,xx,xx,xx,xx,xx,xx
wx,wx,wx,wx,wx,wx,wx,wx,xx,xx
Px,Rx,Px,xx,xx,xx,xx,xx,xx,xx
Px,Px,Px,xx,xx,xx,xx,xx,xx,xx
xx,xx,xx,xx,xx,xx,xx,xx,xx,xx
px,px,px,px,px,xx,xx,xx,xx,xx
px,px,px,px,px,xx,xx,xx,xx,xx
px,px,px,px,px,xx,xx,xx,xx,xx
px,px,px,px,px,xx,xx,xx,xx,xx
px,px,px,px,px,xx,xx,xx,xx,ox
