qo,xx,xx,bx,bx,xx,xx,xx,xx,ox
xx,ox,xx,bx,bx,xx,xx,xx,ox,xx
xx,xx,xx,wx,wx,wx,wx,xx,xx,xx
bx,bx,wx,wx,wx,wx,wx,wx,xx,xx
bx,bx,wx,wx,wx,wx,wx,wx,xx,xx
xx,xx,wx,wx,wx,wx,wx,wx,xx,xx
xx,xx,wx,wx,wx,wx,wx,wx,xx,xx
xx,xx,xx,wx,wx,wx,wx,Px,xx,xx
xx,ox,xx,xx,xx,xx,xx,xx,ox,xx
ox,xx,xx,xx,xx,xx,xx,xx,xx,ox
