wx,wx,wx,wx,wx,wx,wx,wx,wx,wx
wx,wx,wx,wx,wx,wx,wx,wx,wx,wx
wx,wx,wx,wx,wx,wx,wx,wx,wx,wx
wx,wx,wx,xx,xx,xx,xx,xx,wx,wx
ox,ox,ox,ox,xx,xx,xx,xx,wx,wx
ox,ox,ox,ox,xx,wx,wx,xx,xx,wx
wx,wx,px,xx,bx,wx,wx,bx,xx,wx
wx,wx,wx,xx,bx,wx,wx,bx,xx,wx
wx,wx,wx,xx,bx,wx,wx,bx,xx,wx
wx,wx,wx,xx,bx,Px,Qx,bx,xx,wx
