r,x,x,x,x,x,x,x,x,x
x,x,x,x,x,x,x,1,1,1
w,w,w,w,w,w,w,w,x,1
o,b,b,x,2,x,3,x,x,1
w,w,w,x,2,x,3,1,1,1
o,o,x,x,x,x,x,x,x,x
o,o,x,x,x,x,x,x,p,x
w,b,w,x,w,b,w,x,x,x
w,b,w,o,w,b,w,x,x,x
w,o,w,o,w,o,w,o,x,x