w,w,w,w,w,w,w,w,w,w
w,w,w,w,w,w,w,w,w,w
w,w,w,w,w,w,w,w,w,w
w,w,w,x,x,x,x,x,w,w
o,o,o,o,x,x,x,x,w,w
o,o,o,o,x,w,w,x,x,w
w,w,p,x,b,w,w,b,x,w
w,w,w,x,b,w,w,b,x,w
w,w,w,x,b,w,w,b,x,w
w,w,w,x,b,q,r,b,x,w
