xx,px,px,px,px,px,px,px,px,xx
px,px,1x,1x,px,px,px,px,px,px
px,px,1x,px,px,px,px,px,px,px
px,1x,1x,px,px,px,px,px,px,px
px,px,px,px,px,px,px,px,px,px
px,px,px,px,px,px,px,px,px,px
px,px,px,px,px,px,px,px,px,px
px,px,px,px,px,px,px,px,po,po
px,px,px,px,px,px,px,px,po,px
xx,px,px,px,px,px,px,po,po,xx
