po,xx,xx,xx,xx,xx,xx,xx,xx,ox
xx,xx,xx,xx,xx,xx,xx,xx,xx,xx
xx,xx,xx,xx,xx,xx,xx,xx,xx,xx
xx,xx,xx,Px,xx,xx,xx,xx,xx,xx
xx,xx,xx,xx,bx,bx,xx,xx,xx,xx
xx,xx,xx,xx,bx,bx,xx,xx,xx,xx
xx,xx,xx,xx,xx,xx,Qx,xx,xx,xx
xx,xx,xx,xx,xx,xx,xx,xx,xx,xx
xx,xx,xx,xx,xx,xx,xx,xx,xx,xx
ox,xx,xx,xx,xx,xx,xx,xx,xx,ox
