xx,xx,xx,rx,bx,bx,bx,xx,xx,px
xx,xx,xx,bx,bx,bx,xx,xx,xx,xx
xx,xx,xx,bx,bx,bx,xx,xx,xx,xx
xx,xx,xx,bx,bx,xx,xx,xx,xx,xx
xx,xx,bx,bx,xx,xx,xx,xx,xx,xx
xx,xx,xx,wx,xx,wx,xx,xx,xx,xx
xx,xx,wx,wx,xo,wx,wx,xx,xx,xx
xx,xx,wx,wx,xo,wx,wx,xx,xx,xx
xx,xx,wx,wx,bo,bx,wx,xx,xx,xx
xx,ox,bx,wx,ox,ox,wx,xx,xx,xx
