bx,wx,wx,qx,wx,wx,bx,wx,wx,qx
xx,xx,wx,xx,wx,wx,xx,wx,wx,xx
xx,wx,wx,ox,xx,wx,xx,wx,wx,xx
xx,wx,wx,xx,wx,wx,xx,wx,xx,xx
xx,xx,wx,xx,wx,wx,ox,xx,wx,xx
xx,wx,wx,xx,wx,wx,xx,wx,wx,ox
ox,wx,wx,xx,wx,xx,xx,wx,wx,xx
xx,wx,xx,xx,wx,wx,xx,wx,wx,xx
xx,wx,wx,xx,wx,wx,xx,wx,xx,xx
qx,wx,wx,bx,wx,wx,qx,wx,wx,bx
