xx,px,xx,wx,bx,wx,xx,xx,xx,xx
xx,xx,xx,wx,ox,wx,xx,xx,wx,xx
xx,xx,xx,wx,Px,wx,wx,xx,wx,xx
xx,xx,xx,xx,xx,wx,wx,xx,wx,xx
wx,wx,wx,xx,xx,wx,wx,xx,wx,ox
bx,xx,wx,xx,xx,xx,xx,xx,xx,xx
ox,xx,xx,xx,xx,bx,wx,wx,wx,wx
ox,xx,xx,xx,wx,wx,xx,xx,xx,xx
wx,wx,Qx,Rx,wx,wx,xx,xx,xx,xx
xx,xx,bx,xx,wx,wx,xx,xx,xx,xx
